   with any| because of any| you are| when are they| they believe| I believe so| you believed| she believes| this can| we can't| that could| who did| how did it| it did not| he did that| I did this,

   why didn't| could do| I do it| you do not| you do that| I do this| it does| there does not| it doesn't| hundred dollars| why don't| and ever| and ever been| and ever had| because feel,

  I felt| you get| we go| to go to| would go to the| which goes| who got| they guess| it had| has happened| didn't have any| you have| there have been| they have had| we have not|  you have seen,

  on her| through him| does his| he is| this is not| there isn't| so it| and it is| you know| very little| tell me| you mean| of my,

    I need| may need to be| you need to| we need to do| we need to have| we need to go| she needs| it needs to be| that needs to| we needed to be| you needed to| he needed to do| I needed to go| he needed to have| this never| that's not| parts of| 

   copy of the| your question| my question is| his questioning| their questions| you recall| you remember| it said| we saw| you say| he says| we see| before she| how should| I should not| he shouldn't| all that,
 
   all that's| as the| there's the| from their| about them| by these| were they| when they are| before they can| if they can't| that they have| could they have been| and they were| I think| I think so| though this is| all this| in those,
  
   to understand| at us| we want| they want to| she wanted| who wants| what was| it wasn't| and went| he went to| you went to the| and went to this| you were| you were the| why were they| it will| I would,

and also| I've always| year and a half| there aren't| I didn't ask| will ask for| I ask her| I ask him| I ask you| you asked| if asked for| they asked her| he asked him| she asked you| there can be| it could be| five days| few days ago|  we explain,
  
  very fast| and find| tries to find out| she found| who had been| it hadn't| this has| what has been| there has not| he hasn't| who hasn't been| I hear| have you heard| he hears| which is the| for its| it's like| they look| we look at,
  
  I look at it| if you look at that| you look at the| I look at this| they looked| he looks| it made| to make| will make sure| which makes| in making| we may| this may be| you may have| there may have been| she may have had| that may not| five minutes| three months,
   
   few months ago| you must| it must be| he must have| it must have been| his name| your name is| their names| I realize| I couldn't really| he didn't recognize| has recognized| he recognizes| it don't tell| you can't tell us| I couldn't tell you,
   
    right thing| the thing is| good things| my thought| every time| great times| he was not| it was the| there were not| we weren't| you will be| they will have| I will not,
    
     you work| he worked| it would be| she would have| that would have been| there wouldn't have| I wouldn't have been| which would not| who would say| we wouldn't| this wouldn't be| couple years| couple years ago,

we actually| I agree| one and a half months| eight and a half years| can anybody| had anyone| on anything| you are the| our best| he came| they came back| we came down| it came from,
  
  you came in| you came out| she came over| he came up| we can say| they cannot| three children| here come| it could have been| this could not| why couldn't| that day| whole day,

 you describe| they don't expect| 7:15| 9:15| they figure| he figured| we figured out| to figure out| my first| 10:45| she gave| had gave her| have gave him| he gave me,
 
 but gave them| have gave us| he gave you| you give| I give her| it give him| to give me| had give them| they give us| we give you| I'm going to,
 
  who's gonna| and it's gonna be| we gonna do| they had to be| this has to be| he doesn't have anything| she couldn't have anything else| you have an| they haven't| I hope| he hoped| she hopes| there is just| how is that| that is your| their job| they're just,
  
 it keep| who keeps| he kept| you knew| and live| I lived| because lives| she meant| we mentioned| who might| it might be| that might have| there might have been| you might not| any more| is now| ten o'clock| couple of days ago| number of days,
 
 couple of months| couple of months ago| that only| would you please| good point| two points| I put| he puts| you read| can review| I reviewed| after school| it should be| we should have| they should have been| right side| when somebody| if someone| how to spell,
 
 we start| it started| he still| to take| which takes| I talk| you talk to| and talk about it| but talk about| he talked| had talked about it| I talked about| they talked to| we talked to the| we're talking about| who talks| she talks to| he talks about it| it talks about,
 
 he don't tell me| she testified| he testified earlier| your testimony| where that is| whether that was| which then| sit there| who there are| if there's| why there is| so they're| when they've| 9:30| about this was| I told| he told her| you told him| they told me| she told them,
 
   she told us| I told you| who took| we understand that| we understood| he usually| that was just| no way| couple weeks| couple weeks ago| on what| that's what's| they wish| he wished| he wishes| it won't| I won't be| if you'll| and you're|    drug abuse| had agreed| how all| it arrived| may call| she called| and calling| he calls| is checked| should currently| third degree| second-degree| your estimate| did you ever hear| have you ever heard,
   
   you find out| fourth floor| they forget| who forgets| you found out| and had not| right-hand side| so hard| to have any other| don't have any reason| I have enough| please identify| can you identify that| would you identify this| what in the world,
   
    and indicate| but indicated| he indicates| that is your| they learn| we learned| you're learning| he learns| to leave| we left| who let| will listen| you listen to| that listen to this| he mentions,
    
     can meet| he meets| he met| Thursday night| this night| they receive| which received| your recollection| should represent| I represented| who represents| he shall| take some| to speak| we speak up,
     
     not specifically| she spoke| who spoke up| why state| you stated| and states| but stay| could stayed| for staying| he stays| I stop| it stopped| what there was| when there wasn't,
     
     could use| had used| he used to| I used to be| it used to do| she used to go| she used to have| she's using| should wait| so was that| something we are| weren't when| with where| about where is| because whom|    taking advantage| took advantage of| take advantage of it| take advantage of the| we can't afford| it couldn't afford it| she can't afford to| to answer| 
      
     was anything else| can you be more specific| could be sure| I can't be sure| it better not| she better| they both| who can't tell him| you certainly,
     
     it couldn't tell him| who didn't tell him| they don't tell him| he doesn't drink| to drink| your fall| had fell| she didn't get a chance| should get rid of| they graduated from high school| you graduated,
     
     I guess so| I hear this| it might not be| she might not have| there might not have been| they might say| I must not have been| this must not| we must not be| which must not have,
     
     not necessarily| it don't object| it observe| she observed| their parents| we couldn't particularly| bad place| one pound| ten pounds,
     
       he recommend| how recommended| she recommends| which response| there send| this sends| we sent| what shall not| they shouldn't be| I shouldn't have been,
    
     they can't stand| we don't understand it| who usually does| they walk| we walked back| which walked down| you walked in| you walked out| she walked| he walked up,
     
      before was this| can we have| and went out to eat| he went there| that were just| wasn't who| we will find| you would never,